####################
##E      ######   ##
## ##### ###### ####
## #####        ####
######## ###########
######## ###########
######## ###########
######## ###########
######## ###########
##              ####
## ########### #####
## #######F### #####
## ####### ### #####
#  #######     #####
####################